111111
1P0CE1
10C001
101101
1C11C1
100001
111111