1111111
1P000E1
1000001
1C000C1
1111111