1111111
1P10101
10001E1
1C000C1
1111111