1111111111
1E00010001
101A000101
1000C101C1
1P1001C101
1111111111