111111
1E0101
100P01
1C1C01
111111