11111111
1E000101
101A0001
1000C101
1P1001C1
11111111