11111111
1E0000A1
10100001
1000C101
1P1001C1
11111111