1111111
1P1C111
10101E1
1C000C1
1111111