11111111111111
1P101000000001
10001E00000001
1C000C00000001
11111111111111