11111111111111
1P1C1C0000C001
10001001111001
1C000C00000001
11101111101111
10000001000001
10101010010011
11101E10100001
1C000C00000001
11111111111111