11111111111111
1P1C100C1CC001
10001001011011
1C000000C0C0E1
11111111111111
