11111111111111
1P1C110C1CC001
10101001111011
1C000000C0C0E1
11111100000101
10010001111111
101C100C1CC001
10101001011011
1C000000C0C001
11111111111111